888888888
888888888
888888888
888888888
wwwwwwwww
w1111111w
w1111111w
w1119111w
w1111111w
w1111111w
w1111111w
w1111111w
w1111111w
w1111111w
w1111111w
w1111111w
w1111111w
w1111111w
w1111111w
w1111111w
w1111111w
w1111111w
w1111111w
w1111111w
wwwwwwwww
888888888
888888888
888888888
888888888
