888888888
888888888
888888888
888888888
888888888
811191118
811111118
811111118
811111118
811111118
811111118
811111118
811111118
811111118
811111118
811111118
811111118
888888888
888888888
888888888
888888888
888888888
